NO textures/pool.xpm
SO textures/pool.xpm
WE textures/pool.xpm
EA textures/pool.xpm
C 212,228,240
F 7,136,229

11111111111
10000000001
10000000001
10000000001
100000W0001
10000000001
10000000001
11111111111
