NO textures/wall.xpm
SO textures/wall.xpm
WE textures/wall.xpm
EA textures/wall.xpm
F 0,32,100
C 32,32,32

11111111
10000001
10000001
10000001
10000001
111D1111
10000001
100E0001
11111111
