NO textures/wall.xpm
SO textures/tubes.xpm
WE textures/backrooms.xpm
EA textures/pool.xpm
F 0,32,100
C 32,32,32

111111111111111
1000000000000001
11D10111111111D1
11D1D101111111D1
1000000111111101
111D111111111101
10000001111111D1
100E000100000001
1111111101010101
10000001D1D1D1D1
1000000000000001
1000000000000001
1000000000000001
1000000000000001
1000000000000001
1000000000000001
1000000000000001
1000000000000001
1000000000000001
1000000000000001
1000000000000001
1000000000000001
1000000000000001
1000000000000001
1000000000000001
1000000000000001
1000000000000001
1000000000000001
1000000000000001
1000000000000001
1000000000000001
1000000000000001
1000000000000001
1111111111111111
