NO textures/backrooms.xpm
SO textures/pool.xpm
WE textures/wall.xpm
EA textures/tubes.xpm
F 0,32,100
C 32,32,32

11111111111111111111
10000000000000000001
111D1111111111111111
10000000001000000001
1000000000D000000001
10000000001000000001
111D1111111111111111
10000000000000000001
100E0000000000000001
11111111111111111111
