NO textures/backrooms.xpm
SO textures/pool.xpm
WE textures/wall.xpm
EA textures/tubes.xpm
F 0,255,0
C 0,0,255

11111111
10000001
10000001
10000001
10000001
111D1111
10000001
10000001
1111E011
11111111
