NO textures/backrooms.xpm
SO textures/pool.xpm
WE textures/wall.xpm
EA textures/tubes.xpm
F 0,255,0
C 0,0,255

11111111
10000001
10000001
10000001
10000001
111D1111
10000001
10000001
11111111
1
1
1
11
1
1
1
1
1
1
1
1111111
1111E01
1111111
