NO textures/backrooms.xpm
SO textures/pool.xpm
WE textures/wall.xpm
EA textures/tubes.xpm
F 0,32,100
C 32,32,32

1111
10E1
1111
