NO textures/backrooms.xpm
SO textures/backrooms.xpm
WE textures/backrooms.xpm
EA textures/vertical.xpm
F 0,32,100
C 32,32,32

11111111111111111
1E011000000000011
10010101010101011
10010101010101011
10000000000000001
10000000000000001
11111110000011111
11111111111111111
