NO /Users/mamazari/Desktop/42-cursus/cub3d/textures/wall.xpm
SO /Users/mamazari/Desktop/42-cursus/cub3d/textures/wall.xpm

WE /Users/mamazari/Desktop/42-cursus/cub3d/textures/wall.xpm

EA /Users/mamazari/Desktop/42-cursus/cub3d/textures/wall.xpm
F 0,32,32





C 32,F,32


1111111111111
100000N000001
1000000000001
1111111111111