NO textures/wall.xpm
SO textures/wall.xpm

WE textures/wall.xpm

EA textures/wall.xpm
F 0,32,32





C 32,32,32


11
1
01111111111111111111111111111111111
000000000010000000000000000000000001
100000000010000000000000000000000001  1
1000000111000000000000000001000000001
1000N00DDD00000000000000001 10000001
10000001110000000000000000011000001
100000000000000000000000000000000001
100000000000000000000000000000000001
111111111111111111111111111111111111
11111111111							1
10000000011							1
11111111111							1
