NO textures/wall.xpm
SO textures/wall.xpm

WE textures/wall.xpm

EA textures/wall.xpm
F 0,32,32





C 32,32,32

11
1
11111111111111111111111111111111111
100000000010000000000000000000000001
100000000010000000000000000000000001  1
1000000111000000000000000000000000001
1000E00DDD00000000000000000000000001
10000001110000000000000000000000001
100000000000000000000000000000000001
100000000000000000000000000000000001
111111DDD111111111111111111111111111
111111D1111							1
1 000000011							1
11111111111							1
