NO /Users/mamazari/Desktop/42-cursus/cub3d/textures/wall.xpm
SO /Users/mamazari/Desktop/42-cursus/cub3d/textures/wall.xpm

WE /Users/mamazari/Desktop/42-cursus/cub3d/textures/wall.xpm

EA /Users/mamazari/Desktop/42-cursus/cub3d/textures/wall.xpm
F 0,32,32





C 32,32,32


11
1
11111111111111111111111111111111111
100000000010000000000000000000000001
100000000010000000000000000000000001  1
1000000111000000000000000001000000001
1000N0000000000000001000001110000001
10000001110000000000000000000000111
100000000000000000001000101000000001
1000000000000000000000000000000000D1
111111111111111111111111111111111111
11111111111							1
10000000011							1
11111111111							1
